Four Corners,20,20,1;1,18;1,1;18,18;18
0,0,0,0,0,0,3,3,0,0,0,0,3,3,0,0,0,0,0,0
0,0,1,1,1,0,3,0,0,2,2,0,0,3,0,1,1,1,0,0
0,1,1,0,1,0,0,0,0,2,2,0,0,0,0,1,0,1,1,0
0,1,0,2,1,1,1,0,0,0,0,0,1,1,1,1,2,0,1,0
0,1,1,1,0,3,1,0,4,4,4,4,0,1,3,0,1,1,1,0
0,0,0,1,3,3,1,0,4,1,1,4,0,1,3,3,1,0,0,0
3,3,0,1,1,1,1,0,4,1,1,4,0,1,1,1,1,0,3,3
3,0,0,0,0,0,0,0,4,1,1,4,0,0,0,0,0,0,0,3
0,0,0,0,4,4,4,4,4,1,1,4,4,4,4,4,0,0,0,0
0,2,2,0,4,1,1,1,1,1,1,1,1,1,1,4,0,2,2,0
0,2,2,0,4,1,1,1,1,1,1,1,1,1,1,4,0,2,2,0
0,0,0,0,4,4,4,4,4,1,1,4,4,4,4,4,0,0,0,0
3,0,0,0,0,0,0,0,4,1,1,4,0,0,0,0,0,0,0,3
3,3,0,1,1,1,1,0,4,1,1,4,0,1,1,1,1,0,3,3
0,0,0,1,3,3,1,0,4,1,1,4,0,1,3,3,1,0,0,0
0,1,1,1,0,3,1,0,4,4,4,4,0,1,3,0,1,1,1,0
0,1,0,2,1,1,1,0,0,0,0,0,1,1,1,1,2,0,1,0
0,1,1,0,1,0,0,0,0,2,2,0,0,0,0,1,0,1,1,0
0,0,1,1,1,0,3,0,0,2,2,0,0,3,0,1,1,1,0,0
0,0,0,0,0,0,3,3,0,0,0,0,3,3,0,0,0,0,0,0
