Oasis Cross,20,20,10;1,18;10,9;18,1;9
0,0,0,0,0,0,0,3,3,0,0,3,3,0,0,0,0,0,0,0
0,0,3,1,1,1,0,0,0,0,0,0,0,0,1,1,1,3,0,0
0,3,3,1,2,1,0,2,0,0,0,0,2,0,1,2,1,3,3,0
0,1,1,1,0,1,1,1,0,3,3,0,1,1,1,0,1,1,1,0
0,1,2,0,0,0,3,1,0,0,0,0,1,3,0,0,0,2,1,0
0,1,1,1,0,0,0,1,1,1,1,1,1,0,0,0,1,1,1,0
0,0,0,1,1,1,0,0,4,4,4,4,0,0,1,1,1,0,0,0
3,0,2,0,3,1,0,4,4,1,1,4,4,0,1,3,0,2,0,3
3,0,0,1,0,1,4,4,1,1,1,1,4,4,1,0,1,0,0,3
0,0,0,1,0,1,4,1,1,2,2,1,1,4,1,0,1,0,0,0
0,0,0,1,0,1,4,1,1,2,2,1,1,4,1,0,1,0,0,0
3,0,0,1,0,1,4,4,1,1,1,1,4,4,1,0,1,0,0,3
3,0,2,0,3,1,0,4,4,1,1,4,4,0,1,3,0,2,0,3
0,0,0,1,1,1,0,0,4,4,4,4,0,0,1,1,1,0,0,0
0,1,1,1,0,0,0,1,1,1,1,1,1,0,0,0,1,1,1,0
0,1,2,0,0,0,3,1,0,0,0,0,1,3,0,0,0,2,1,0
0,1,1,1,0,1,1,1,0,3,3,0,1,1,1,0,1,1,1,0
0,3,3,1,2,1,0,2,0,0,0,0,2,0,1,2,1,3,3,0
0,0,3,1,1,1,0,0,0,0,0,0,0,0,1,1,1,3,0,0
0,0,0,0,0,0,0,3,3,0,0,3,3,0,0,0,0,0,0,0
