River Bend,20,20,1;10,18;9
0,0,0,0,0,0,3,3,0,0,0,0,3,3,0,0,0,0,0,0
0,3,0,0,1,1,1,0,0,2,2,0,0,1,1,1,0,0,3,0
0,0,0,2,1,4,1,0,0,0,0,0,0,1,4,1,2,0,0,0
0,0,2,2,1,4,1,3,0,0,0,0,3,1,4,1,2,2,0,0
1,1,1,1,1,4,1,1,1,0,0,1,1,1,4,1,1,1,1,1
0,0,0,3,0,4,4,4,1,0,0,1,4,4,4,0,3,0,0,0
0,2,0,0,0,0,0,4,1,2,2,1,4,0,0,0,0,0,2,0
0,2,0,3,3,0,0,4,1,0,0,1,4,0,0,3,3,0,2,0
0,0,0,0,0,0,0,4,1,0,0,1,4,0,0,0,0,0,0,0
0,3,1,1,1,1,1,1,1,0,0,1,1,1,1,1,1,1,3,0
0,3,1,1,1,1,1,1,1,0,0,1,1,1,1,1,1,1,3,0
0,0,0,0,0,0,0,4,1,0,0,1,4,0,0,0,0,0,0,0
0,2,0,3,3,0,0,4,1,0,0,1,4,0,0,3,3,0,2,0
0,2,0,0,0,0,0,4,1,2,2,1,4,0,0,0,0,0,2,0
0,0,0,3,0,4,4,4,1,0,0,1,4,4,4,0,3,0,0,0
1,1,1,1,1,4,1,1,1,0,0,1,1,1,4,1,1,1,1,1
0,0,2,2,1,4,1,3,0,0,0,0,3,1,4,1,2,2,0,0
0,0,0,2,1,4,1,0,0,0,0,0,0,1,4,1,2,0,0,0
0,3,0,0,1,1,1,0,0,2,2,0,0,1,1,1,0,0,3,0
0,0,0,0,0,0,3,3,0,0,0,0,3,3,0,0,0,0,0,0
